Clementine Way
An Interactive Fiction by Brent Uramoto
Release 1 / Serial number 141024 / Inform 7 build 6L38 (I6/v6.33 lib 6/12N) SD

>x oven
(Oven)
A standard eletric oven. It is fairly new, I only bought it six months ago. The oven controls is a simple knob that has different temeratures on it. 300, 350 and 400.

>turn controls to 300
The oven starts to get warm, and after a few minutes, the temperature skyrockets to 300ºF.

>x oven
(Oven)
A standard eletric oven. It is fairly new, I only bought it six months ago. The oven controls is a simple knob that has different temeratures on it. 300, 350 and 400. Now the oven is at a hot 300ºF.

>turn controls to 400
The oven temperature soars until it reaches 400ºF. Even standing a few feet away from it, you can feel the heat bouncing off your face.

I beg your pardon?

>turn oven controls to 400
The oven temperature soars until it reaches 400ºF. Even standing a few feet away from it, you can feel the heat bouncing off your face.

>x oven
(Oven)
A standard eletric oven. It is fairly new, I only bought it six months ago. The oven controls is a simple knob that has different temeratures on it. 300, 350 and 400.  Now the oven is at a searing 400ºF

* * *

>x oven
(Oven)
A standard eletric oven. It is fairly new, I only bought it six months ago. The oven controls is a simple knob that has different temeratures on it. 300, 350 and 400.

>turn oven controls to 300
The oven is starting to get warm.

>x oven
(Oven)
A standard eletric oven. It is fairly new, I only bought it six months ago. The oven controls is a simple knob that has different temeratures on it. 300, 350 and 400.

* * *

Clementine Way
An Interactive Fiction by Brent Uramoto
Release 1 / Serial number 141024 / Inform 7 build 6L38 (I6/v6.33 lib 6/12N) SD

>hello
That's not a verb I recognise.

>x me
As good-looking as ever.

>xme
That's not a verb I recognise.

>x me
As good-looking as ever.

>x me
As good-looking as ever.

>yes
That was a rhetorical question.

>are you there?
That's not a verb I recognise.

>no
That was a rhetorical question.

* * *

Clementine Way
An Interactive Fiction by Brent Uramoto
Release 1 / Serial number 141024 / Inform 7 build 6L38 (I6/v6.33 lib 6/12N) SD

>take oven controls
That seems to be a part of Oven.

* * *

Clementine Way
An Interactive Fiction by Brent Uramoto
Release 1 / Serial number 141024 / Inform 7 build 6L38 (I6/v6.33 lib 6/12N) SD

>turn oven controls to 200
The oven is starting to get warm.

* * *

Clementine Way
An Interactive Fiction by Brent Uramoto
Release 1 / Serial number 141024 / Inform 7 build 6L38 (I6/v6.33 lib 6/12N) SD

>x recipe locker
I only understood you as far as wanting to examine Recipe storage.

>x recipe storage
It is a white wood locker that I keep my recipes in. It is closed.

* * *

Clementine Way
An Interactive Fiction by Brent Uramoto
Release 1 / Serial number 141024 / Inform 7 build 6L38 (I6/v6.33 lib 6/12N) SD

>x recipe storage
It is a white wood locker that I keep my recipes in. It is closed.

>open
(Unlabled can of soup)
It seems to be locked.

>open recipe storage
You open Recipe storage, revealing Old recipe.

>open recipe storage
That's already open.

>x recipe storage
It is a white wood locker that I keep my recipes in.It is open. There are a bunch of interesting recpies in here, but ther is one that you had intended to make for Jennifer.

In Recipe storage is Old recipe.

>take old recipe
Taken.

>x old recipe
This is a dish that Jennifer and I used to make when we were kids. It is still a good recipe, in fact, I made it a month ago, and it tasted great! But I accidentally ripped the paper when I made it last time. To make matters worse, I've completely forgotten how to make it. I can only make out some writing of the scraps. "Soup"..."oven"..."smokey"..."M and Ms". Not going to be much help, but it's all I got for now.

>l
My Kitchen
This is where I cook my meals everyday. It is a medium sized room with standard kitchen appliances. The oven is in the far corner of the room, and the stove is to your right, and a smoke vent is above it. The refrigerator is on the right wall. There is a marble table in the middle of the room. My recipe locker is next to the refridgerator. The kitchen is lit by while fourecent lights and a window that looks out into the yard.

* * *

Clementine Way
An Interactive Fiction by Brent Uramoto
Release 1 / Serial number 141024 / Inform 7 build 6L38 (I6/v6.33 lib 6/12N) SD

>i
You are carrying nothing.

>l
Instead of looking rule triggered

>l
asdf

>l
asdf

>l'l
That's not a verb I recognise.

>ll
That's not a verb I recognise.

>l
asdf

* * *

>i
You are carrying nothing.

>rules on
Rules tracing now switched on. Type "rules off" to switch it off again, or "rules all" to include even rules which do not apply.

>l
[Rule "declare everything initially unmentioned rule" applies.]
[Rule "determine visibility ceiling rule" applies.]
[Rule "announce items from multiple object lists rule" applies.]
[Rule "set pronouns from items from multiple object lists rule" applies.]
[Rule "before stage rule" applies.]
[Rule "instead stage rule" applies.]
[Rule "Instead of looking" applies.]
asdf
[Rule "A first turn sequence rule" applies.]
[Rule "every turn stage rule" applies.]
[Rule "An every turn rule" applies.]
[Rule "An every turn rule" applies.]
[Rule "A last turn sequence rule" applies.]
[Rule "notify score changes rule" applies.]

* * *

Clementine Way
An Interactive Fiction by Brent Uramoto
Release 1 / Serial number 141024 / Inform 7 build 6L38 (I6/v6.33 lib 6/12N) SD

>s
Bed Room
This is where I sleep every night. My bed is right in front of me, the phone and my address book is on the nightstand to the left of the bed, and a desk lamp lights the room. The Kitchen is to the north.

>l
asdf

>take phone
Taken.

* * *

>l
asdf

>s
You can't go that way.

>n
My Kitchen
This is where I cook my meals. It is a medium sized room with an oven and a refrigerator. The oven is in the far corner of the room, The refrigerator is on the right wall. There is a marble table in the middle of the room. My recipe locker is next to the refrigerator. The kitchen is lit by while florescent lights and a window that looks out into the yard. The Dining Room is to the west, the Bed Room is to the south, the Living room is to the east.

>l
asdf

* * *

>s
Bed Room
This is where I sleep every night. My bed is right in front of me, the phone and my address book is on the nightstand to the left of the bed, and a desk lamp lights the room. The Kitchen is to the north.

>x adress book
You can't see any such thing.

>open adress book
You can't see any such thing.

>x jennifer's number
You can't see any such thing.

* * *

>l
Bed Room
This is where I sleep every night. My bed is right in front of me, the phone and my address book is on the nightstand to the left of the bed, and a desk lamp lights the room. The Kitchen is to the north.

>take phone
Taken.

* * *

Clementine Way
An Interactive Fiction by Brent Uramoto
Release 1 / Serial number 141024 / Inform 7 build 6L38 (I6/v6.33 lib 6/12N) SD

>w
Dining Room
This is where meals are eaten. It is a small room consisting of a small wood table, 2 wood chairs, and a utensil cabinet. A glass chandelier casts a warm glow in the room. There is a window that looks out onto Clementine Way. The Kitchen is to the east.

>e
My Kitchen
This is where I cook my meals. It is a medium sized room with an oven and a refrigerator. The oven is in the far corner of the room, The refrigerator is on the right wall. There is a marble table in the middle of the room. My recipe locker is next to the refrigerator. The kitchen is lit by while florescent lights and a window that looks out into the yard. The Dining Room is to the west, the Bed Room is to the south, the Living room is to the east.

>e
Living Room
This is the living room where I sit on the couch and watch TV. My address book is here on the coffee table.  The Street is past the front door to the north.

You can see Coffee Table here.

>take table
That's fixed in place.

>open adress book
You can't see any such thing.

>open book
You open Address Book, revealing Jennifer's Number, Mitch's Number, Margret's Number and Steve's Number.

>x Jennifer's number
424-8475

>w
My Kitchen
This is where I cook my meals. It is a medium sized room with an oven and a refrigerator. The oven is in the far corner of the room, The refrigerator is on the right wall. There is a marble table in the middle of the room. My recipe locker is next to the refrigerator. The kitchen is lit by while florescent lights and a window that looks out into the yard. The Dining Room is to the west, the Bed Room is to the south, the Living room is to the east.

>s
Bed Room
This is where I sleep every night. My bed is right in front of me, the phone and my address book is on the nightstand to the left of the bed, and a desk lamp lights the room. The Kitchen is to the north.

>take phone
Taken.

>call 424-8475
Alright, so I need to ask Jennifer about her plans for tonight. What should I ask about? Dinner? Movies? Shopping? You take a deep breath and dial the number.  After a couple rings, Jennifer's voice comes over the line. "Hello?"

* * *

>424-8475
Alright, so I need to ask Jennifer about her plans for tonight. What should I ask about? Dinner? Movies? Shopping? You take a deep breath and dial the number.  After a couple rings, Jennifer's voice comes over the line. "Hello?"

>ask Jennifer about me
There is no reply.

>ask Jennifer about black tonight
There is no reply.

>ask Jennifer about plans tonight
Um, I dont think I have any plans for tonight. Why? Do you want to do something?

>ask jennifer about dinner
"Hmm... Sure." Says Jennifer. "Oh! Remember that old recipie that we used to make as teens? What was it called? Umm...  Margret's Casserole!" 

 "Yes," you say. "I think I still have that recipe in my recipe drawer." 

 "Ok, cool" responds Jennifer. I still have a lot of work to do, so could you call me back when you have it ready?" 

 "Sure," you say. "I'll call you later."

>ask Jennifer about a dinner
I already asked Jennifer about dinner, and she said yes. No need to ask her again.

>ask Jennifer about dinner
I already asked Jennifer about dinner, and she said yes. No need to ask her again.

>story line
That's not a verb I recognise.

>ask Jennifer about dinner
I already asked Jennifer about dinner, and she said yes. No need to ask her again.

>hang up
"Ok, I have to go now." You say. "Bye!" You press the end call button and put down the phone gently.

>ask Jennifer about dinner
You can't see any such thing.

>n
My Kitchen
This is where I cook my meals. It is a medium sized room with an oven and a refrigerator. The oven is in the far corner of the room, The refrigerator is on the right wall. There is a marble table in the middle of the room. My recipe locker is next to the refrigerator. The kitchen is lit by while florescent lights and a window that looks out into the yard. The Dining Room is to the west, the Bed Room is to the south, the Living room is to the east.

>open pantry
You open Pantry, revealing Onion and Unlabeled can of soup.

>take onion
Taken.

>open refridgerator
You can't see any such thing.

>open refrigerator
You open Refrigerator, revealing Bacon and Chicken.

>take bacon
Taken.

>i
You are carrying:
  Bacon
  Onion

>mix bacon and onion
You can't use multiple objects with that verb.

>mix bacon with onion
You mix the bacon and onions until it is well spread out.

>i
You are carrying:
  Chopped Ingredients

>take chicken
Taken.

>take unlabled can of soup
You can't see any such thing.

>l
You put all the ingredients together and now it is ready to be baked.

>x pantry
The pantry is where I store all the non-perisable food items.

In Pantry is Unlabeled can of soup.

>take unlabled can of soup
You can't see any such thing.

>take Unlabeled can of soup
Taken.

>open soup
You open Unlabeled can of soup, revealing Orange Soup.

>x soupp
You can't see any such thing.

>x soup
(Unlabeled can of soup)
An unlabeled can of soup. The outside is made of the typical shiny corrugated tin. I wonder what's inside it.

In Unlabeled can of soup is Orange Soup.

>x orange soup
An orange-colored soup. I wonder what it tastes like.

>x unlabeled can of soup
An unlabeled can of soup. The outside is made of the typical shiny corrugated tin. I wonder what's inside it.

In Unlabeled can of soup is Orange Soup.

>take orange soup
Taken.

* * *

>i
You are carrying:
  Orange Soup
  Unlabeled can of soup (open but empty)
  Uncooked Mixture
  Chicken

>mix chicken with orange soup
You mix the chicken with the orange-colored soup until the chicken is fully mixed with the soup.

>i
You are carrying:
  Soupy Mixture
  Uncooked Mixture

>i
You are carrying:
  Soupy Mixture
  Uncooked Mixture

>take old recipe
You can't see any such thing.

>take old recipe
You can't see any such thing.

>take Margret's casserole
You can't see any such thing.

>x recipe sorage
I only understood you as far as wanting to examine Recipe storage.

>x recipe storage
It is a white wood locker that I keep my recipes in. It is closed. There are a bunch of interesting recipes in here, but there is one that you had intended to make for Jennifer. Ole Casserole Recipe.

>take margret's casserole recipe
You can't see any such thing.

>take margret's casserole recipe
You can't see any such thing.

>i
You are carrying:
  Soupy Mixture
  Uncooked Mixture

>open recipe storage
You open Recipe storage, revealing Old Casserole recipe.

>take Margret's casserole recipe
You can't see any such thing.

>i
You are carrying:
  Soupy Mixture
  Uncooked Mixture

>mix chopped ingredients with soupy mixture
You can't see any such thing.

>mis soupy mixture with chopped ingredients
That's not a verb I recognise.

>mix soupy mixture with chopped ingredients
You can't see any such thing.

>i
You are carrying:
  Soupy Mixture
  Uncooked Mixture

>put uncooked mixture into oven
(Oven)
Oven is closed.

>open oven
(Oven)
You open Oven.

>put uncooked mixture into oven
(Oven)
You put Uncooked Mixture into Oven.

The Oven isn't on! I need to turn it on before I can cook anything in there.

>i
You are carrying:
  Uncooked Mixture
  Soupy Mixture

>turn oven to 350
(Oven to that)

>x oven
(Oven)
A standard electric oven. It is fairly new, I only bought it six months ago. The oven controls is a simple knob that has different temperatures on it. 300, 350 and 400.

>turn knob to 350
You can't see any such thing.

>turn oven controls to 350
The oven heats up quickly, and you watch as the temperature rises to 350ºF. You can feel some of the heat radiating off of your face.

>put uncooked mixture in oven
(Oven)
You put Uncooked Mixture into Oven.

You carefully put the uncooked mixture into the heated oven. Then, you set the timer for an hour and decide to take a nap. As soon as the casserole is done, you should call Jennifer. 

 You wake up an hour later. A delicous smell floats through out the house. Time to take the casserole out.

>i
You are carrying:
  Soupy Mixture

>l
You put all the ingredients together and now it is ready to be baked.

>x oven
(Oven)
A standard electric oven. It is fairly new, I only bought it six months ago. The oven controls is a simple knob that has different temperatures on it. 300, 350 and 400.  Now the oven is at a scorching 350ºF.

In Oven is Margret's Casserole.

>take margret's casserole
You carefully take the casserole out of the oven. It is still steaming, but it looks scrumptious.

* * *

>take phone
You can't see any such thing.

>take phone
You can't see any such thing.

>take telephone
You can't see any such thing.

>s
Bed Room
This is where I sleep every night. My bed is right in front of me, the phone and my address book is on the nightstand to the left of the bed, and a desk lamp lights the room. The Kitchen is to the north.

You can see Phone here.

>take phone
Taken.

>call 424-8475
After a couple of rings, Jennifer picks up the phone.

 "Hi" says Jennifer. 

"Hello" you say. "I have the casserole ready." 

 "Ok, great, I'll be right over. See you soon!"

    *** you win! ***

Would you like to RESTART, RESTORE a saved game, QUIT or UNDO the last command?