You survived the week! It is now Friday night, and you don't have many things to do. Maybe I should call Jennifer and see if she's doing anything right now. If she's not, then I'll ask if she wants to have dinner with me.

Clementine Way
An Interactive Fiction by Brent Uramoto
Release 1 / Serial number 141028 / Inform 7 build 6L38 (I6/v6.33 lib 6/12N) SD

My Kitchen
This is where I cook my meals. It is a medium sized room with an oven and a refrigerator. The oven is in the far corner of the room, the refrigerator is on the right wall. There is a marble table in the middle of the room. My recipe locker is next to the refrigerator. The Dining Room is to the west, the Bed Room is to the south, the Living room is to the east.

You can see Cigarette Pack (closed), Pantry (closed) and Refrigerator (closed) here.

>take all
You hold out your hand, close your eyes, and consentrate. You will all objects to fly to you, but nothing happens.

>e
Living Room
This is the living room where I sit on the couch and watch TV. My address book is here on the coffee table. The Street is past the front door to the north.

You can see Coffee Table and Address Book (closed) here.

>n
Clementine Way
This is the street that runs past the front of my house. Good thing the street lights are on, otherwise, it would be pitch black. The sidewalk and asphalt are in good condition. Cool Autumn breezes make you shiver slightly. The Intersection by Jennifer's house is to the east, and my house is to the south.

Where am I going? I haven't even contacted Jennifer yet.

Living Room
This is the living room where I sit on the couch and watch TV. My address book is here on the coffee table. The Street is past the front door to the north.

You can see Coffee Table and Address Book (closed) here.

>e
You can't go that way.

>w
My Kitchen
This is where I cook my meals. It is a medium sized room with an oven and a refrigerator. The oven is in the far corner of the room, The refrigerator is on the right wall. There is a marble table in the middle of the room. My recipe locker is next to the refrigerator. The kitchen is lit by while florescent lights and a window that looks out into the yard. The Dining Room is to the west, the Bed Room is to the south, the Living room is to the east.

>s
Bed Room
This is where I sleep every night. My bed is right in front of me, the phone and my address book is on the nightstand to the left of the bed, and a desk lamp lights the room. The Kitchen is to the north.

>take phone
Taken.

>424-4875
That's not a verb I recognise.

>n
My Kitchen
This is where I cook my meals. It is a medium sized room with an oven and a refrigerator. The oven is in the far corner of the room, The refrigerator is on the right wall. There is a marble table in the middle of the room. My recipe locker is next to the refrigerator. The kitchen is lit by while florescent lights and a window that looks out into the yard. The Dining Room is to the west, the Bed Room is to the south, the Living room is to the east.

>w
Dining Room
This is where meals are eaten. It is a small room consisting of a small wood table, 2 wood chairs, and a utensil cabinet. A glass chandelier casts a warm glow in the room. There is a window that looks out onto Clementine Way. The Kitchen is to the east.

>e
My Kitchen
This is where I cook my meals. It is a medium sized room with an oven and a refrigerator. The oven is in the far corner of the room, The refrigerator is on the right wall. There is a marble table in the middle of the room. My recipe locker is next to the refrigerator. The kitchen is lit by while florescent lights and a window that looks out into the yard. The Dining Room is to the west, the Bed Room is to the south, the Living room is to the east.

>e
Living Room
This is the living room where I sit on the couch and watch TV. My address book is here on the coffee table. The Street is past the front door to the north.

You can see Coffee Table and Address Book (closed) here.

>take adress book
You can't see any such thing.

>take address book
Taken.

>open address book
You open Address Book, revealing Jennifer's Number, Mitch's Number, Margret's Number and Steve's Number.

>x jennifer's number
424-8475

>call 424-8475
Alright, so I need to ask Jennifer about her plans for tonight. What should I ask about? Dinner? Movies? Shopping? You take a deep breath and dial the number.  After a couple rings, Jennifer's voice comes over the line. "Hello?"

>jump
You jump on the spot.

>ask jennifer dinner
I didn't understand that sentence.

>ask jennifer about if she is okay
There is no reply.

>ask jennifer about if she is ok
no

* * *

>x oven
(Oven)
A standard electric oven. It is fairly new, I only bought it six months ago. The oven controls has differetent temperatures on it. 300, 350 and 400. It can be set by TURNING oven controls to a temperature

>turn controls to 300
The oven starts to get warm, and after a few minutes, the temperature skyrockets to 300ºF.

>x oven
(Oven)
A standard eletric oven. It is fairly new, I only bought it six months ago. The oven controls is a simple knob that has different temeratures on it. 300, 350 and 400. Now the oven is at a hot 300ºF.

>turn controls to 400
The oven temperature soars until it reaches 400ºF. Even standing a few feet away from it, you can feel the heat bouncing off your face.

I beg your pardon?

>turn oven controls to 400
The oven temperature soars until it reaches 400ºF. Even standing a few feet away from it, you can feel the heat bouncing off your face.

>x oven
(Oven)
A standard eletric oven. It is fairly new, I only bought it six months ago. The oven controls is a simple knob that has different temeratures on it. 300, 350 and 400.  Now the oven is at a searing 400ºF

* * *

>x oven
(Oven)
A standard electric oven. It is fairly new, I only bought it six months ago. The oven controls has differetent temperatures on it. 300, 350 and 400. It can be set by TURNING oven controls to a temperature

>turn oven controls to 300
The oven is starting to get warm.

>x oven
(Oven)
A standard eletric oven. It is fairly new, I only bought it six months ago. The oven controls is a simple knob that has different temeratures on it. 300, 350 and 400.

* * *

>x oven
(Oven)
A standard electric oven. It is fairly new, I only bought it six months ago. The oven controls has differetent temperatures on it. 300, 350 and 400. It can be set by TURNING oven controls to a temperature

>xsotuh
That's not a verb I recognise.

>x south
You see nothing unexpected in that direction.

>jennifers house
That's not a verb I recognise.

>east
Living Room
This is the living room where I sit on the couch and watch TV. My address book is here on the coffee table. The Street is past the front door to the north.

You can see Coffee Table and Address Book (closed) here.

>street
That's not a verb I recognise.

>The street
That's not a verb I recognise.

>north
Clementine Way
This is the street that runs past the front of my house. Good thing the street lights are on, otherwise, it would be pitch black. The sidewalk and asphalt are in good condition. Cool Autumn breezes make you shiver slightly. The Intersection by Jennifer's house is to the east, and my house is to the south.

Where am I going? I haven't even contacted anybody yet.

Living Room
This is the living room where I sit on the couch and watch TV. My address book is here on the coffee table. The Street is past the front door to the north.

You can see Coffee Table and Address Book (closed) here.

>north
Clementine Way
This is the street that runs past the front of my house. Good thing the street lights are on, otherwise, it would be pitch black. The sidewalk and asphalt are in good condition. Cool Autumn breezes make you shiver slightly. The Intersection by Jennifer's house is to the east, and my house is to the south.

Where am I going? I haven't even contacted anybody yet.

Living Room
This is the living room where I sit on the couch and watch TV. My address book is here on the coffee table. The Street is past the front door to the north.

You can see Coffee Table and Address Book (closed) here.

>address book
That's not a verb I recognise.

>x adress book
You can't see any such thing.

>x address book
This is the address book that I keep next to my phone in case I want to call someone.

>x me
I am dressed in casual sports wear. I have a dark blu shirt and black shorts. Nice enough to have a casual dinner.

>open address book
You open Address Book, revealing Jennifer's Number, Mitch's Number, Page's Number and Steve's Number.

>x mitch's number
424-5332

>call 424-5332
I dont have anything to call with!

>i
You are carrying nothing.

>w
My Kitchen
This is where I cook my meals. It is a medium sized room with an oven and a refrigerator. The oven is in the far corner of the room, The refrigerator is on the right wall. There is a marble table in the middle of the room. My recipe locker is next to the refrigerator. The kitchen is lit by while florescent lights and a window that looks out into the yard. The Dining Room is to the west, the Bed Room is to the south, the Living room is to the east.

You can see Cigarette Pack (closed) here.

>s
Bed Room
This is where I sleep every night. My bed is right in front of me, the phone and my address book is on the nightstand to the left of the bed, and a desk lamp lights the room. The Kitchen is to the north.

You can see Phone here.

I beg your pardon?

I beg your pardon?

>l
Bed Room
This is where I sleep every night. My bed is right in front of me, the phone and my address book is on the nightstand to the left of the bed, and a desk lamp lights the room. The Kitchen is to the north.

You can see Phone here.

>take phone
Taken.

>call 424-5332
Mitch picks up the phone. 

 "Hey man, what's up?" He asks. 

 "Nothing much" You say. "Want to go do something tonight?" 

 "Sure" He says. 

 You come back from a long fun night, but you feel like something is still missing.

    ***  Maybe there was someone else that you wanted to spend the night with? ***

Would you like to RESTART, RESTORE a saved game, QUIT or UNDO the last command?

* * *

>x window
You can't see any such thing.

>x oven
(Oven)
A standard electric oven. It is fairly new, I only bought it six months ago. The oven controls is a simple knob that has different temperatures on it. 300, 350 and 400.

>turn knob
You can't see any such thing.

>turn  oven
(Oven)
Nothing obvious happens.

>turn oven to 300
(Oven to that)

>turn oven controles
You can't see any such thing.

>turn oven controls to 300
The oven starts to get warm, and after a few minutes, the temperature skyrockets to 300ºF.

>x refrigerator
A plain white refrigerator. I use it to store all my perishable food.

>open refrigerator
You open Refrigerator, revealing Bacon and Chicken.

>take all
You hold out your hand, close your eyes, and consentrate. You will all objects to fly to you, but nothing happens.

>x bacon
Mmmmm.... Bacon!

>x chicken
Cut up chicken. Perfect for making the casserole.

>x table
A black and white marble table. It's been here as long as my house was here.

>look
My Kitchen
This is where I cook my meals. It is a medium sized room with an oven and a refrigerator. The oven is in the far corner of the room, The refrigerator is on the right wall. There is a marble table in the middle of the room. My recipe locker is next to the refrigerator. The kitchen is lit by while florescent lights and a window that looks out into the yard. The Dining Room is to the west, the Bed Room is to the south, the Living room is to the east.

>x locker
You can't see any such thing.

>x recipe locker
I only understood you as far as wanting to examine Recipe storage.

>x my recipe locker
I only understood you as far as wanting to examine Recipe storage.

>x recipe locker
I only understood you as far as wanting to examine Recipe storage.

>x recipe storage
It is a white wood locker that I keep my recipes in. It is closed.

>open storage
You open Recipe storage, revealing Old Casserole recipe.

>x recipe
(Old Casserole recipe)
This is a dish that Jennifer and I used to make when we were kids. It is still a good recipe, in fact, I made it a month ago, and it tasted great! This is the recipe: 

 Ingredients: bacon, onions, chicken, alfredo soup. 

 Directions: turn oven on to 350 ºF. Mix bacon with onion and then mix chicken and alfredo soup. Then, put into oven for an hour.

>i
You are carrying nothing.

>look
My Kitchen
This is where I cook my meals. It is a medium sized room with an oven and a refrigerator. The oven is in the far corner of the room, The refrigerator is on the right wall. There is a marble table in the middle of the room. My recipe locker is next to the refrigerator. The kitchen is lit by while florescent lights and a window that looks out into the yard. The Dining Room is to the west, the Bed Room is to the south, the Living room is to the east.

>s
Bed Room
This is where I sleep every night. My bed is right in front of me, the phone and my address book is on the nightstand to the left of the bed, and a desk lamp lights the room. The Kitchen is to the north.

>x book
You can't see any such thing.

>turn on lamp
You can't see any such thing.

>take lamp
You can't see any such thing.

>x phone
A regular house phone. I don't use it that often, maybe four times a week. It has a dial pad to put in numbers.

>x address book
You can't see any such thing.

>take phone
Taken.

>n
My Kitchen
This is where I cook my meals. It is a medium sized room with an oven and a refrigerator. The oven is in the far corner of the room, The refrigerator is on the right wall. There is a marble table in the middle of the room. My recipe locker is next to the refrigerator. The kitchen is lit by while florescent lights and a window that looks out into the yard. The Dining Room is to the west, the Bed Room is to the south, the Living room is to the east.

* * *

>w
Dining Room
This is where meals are eaten. It is a small room consisting of a small wood table, 2 wood chairs, and a utensil cabinet. A glass chandelier casts a warm glow in the room. There is a window that looks out onto Clementine Way. The Kitchen is to the east.

>open cabinet
You can't see any such thing.

>take all
You hold out your hand, close your eyes, and consentrate. You will all objects to fly to you, but nothing happens.

>e
My Kitchen
This is where I cook my meals. It is a medium sized room with an oven and a refrigerator. The oven is in the far corner of the room, The refrigerator is on the right wall. There is a marble table in the middle of the room. My recipe locker is next to the refrigerator. The kitchen is lit by while florescent lights and a window that looks out into the yard. The Dining Room is to the west, the Bed Room is to the south, the Living room is to the east.

>e
Living Room
This is the living room where I sit on the couch and watch TV. My address book is here on the coffee table.  The Street is past the front door to the north.

You can see Coffee Table here.

>stand on coffee table
That's not something you can stand on.

>x address book
This is the address book that I keep next to my phone in case I want to call someone.

>open address book
You open Address Book, revealing Jennifer's Number, Mitch's Number, Margret's Number and Steve's Number.

>x jennifer
You can't see any such thing.

>x jennifer's number
424-8475

>x mitch's number
424-5332

>call 4245332
I didn't understand that sentence.

>call 424-8475
Alright, so I need to ask Jennifer about her plans for tonight. What should I ask about? Dinner? Movies? Shopping? You take a deep breath and dial the number.  After a couple rings, Jennifer's voice comes over the line. "Hello?"

>hi
That's not a verb I recognise.

>ask about movies
You can't see any such thing.

>ask Jennifer about movies
There is no reply.

>ask jennifer about shopping
There is no reply.

>ask jennifer about plans
Um, I dont think I have any plans for tonight. Why? Do you want to do something?

>ask jennifer about dinner
"Hmm... Sure." Says Jennifer. "Oh! Remember that old recipie that we used to make as teens? What was it called? Umm...  Margret's Casserole!" 

 "Yes," you say. "I think I still have that recipe in my recipe drawer." 

 "Ok, cool" responds Jennifer. I still have a lot of work to do, so could you call me back when you have it ready?" 

 "Sure," you say. "I'll call you later."

>e
You can't go that way.

* * *

>w
My Kitchen
This is where I cook my meals. It is a medium sized room with an oven and a refrigerator. The oven is in the far corner of the room, The refrigerator is on the right wall. There is a marble table in the middle of the room. My recipe locker is next to the refrigerator. The kitchen is lit by while florescent lights and a window that looks out into the yard. The Dining Room is to the west, the Bed Room is to the south, the Living room is to the east.

>end call
"Ok, I have to go now." You say. "Bye!" You press the end call button and put down the phone gently.

>x recipe
(Old Casserole recipe)
This is a dish that Jennifer and I used to make when we were kids. It is still a good recipe, in fact, I made it a month ago, and it tasted great! This is the recipe: 

 Ingredients: bacon, onions, chicken, alfredo soup. 

 Directions: turn oven on to 350 ºF. Mix bacon with onion and then mix chicken and alfredo soup. Then, put into oven for an hour.

>take recipe
(Old Casserole recipe)
Taken.

>x pantry
The pantry is where I store all the non-perisable food items.

>open pantry
You open Pantry, revealing Onion and Unlabeled can of soup.

>take all
You hold out your hand, close your eyes, and consentrate. You will all objects to fly to you, but nothing happens.

>turn oven controls to 350
The oven heats up quickly, and you watch as the temperature rises to 350ºF. You can feel some of the heat radiating off of your face.

>mix bacon with onion
You mix the bacon and onions until it is well spread out.

>i
You are carrying:
  Chopped Ingredients
  Old Casserole recipe

>x can
An unlabeled can of soup. The outside is made of the typical shiny corrugated tin. I wonder what's inside it.

>mix chicken and alfredo soup
You can't use multiple objects with that verb.

>open can
You open Unlabeled can of soup, revealing Orange Soup.

>x soup
Which do you mean, Unlabeled can of soup or Orange Soup?

>mix chicken and soup
You can't use multiple objects with that verb.

>mix chicken with soup
Which do you mean, Unlabeled can of soup or Orange Soup?

>i
You are carrying:
  Chopped Ingredients
  Old Casserole recipe

>mix chicken with orange soup
You mix the chicken with the orange-colored soup until the chicken is fully mixed with the soup.

>i
You are carrying:
  Soupy Mixture
  Chopped Ingredients
  Old Casserole recipe

>x recipe
(Old Casserole recipe)
This is a dish that Jennifer and I used to make when we were kids. It is still a good recipe, in fact, I made it a month ago, and it tasted great! This is the recipe: 

 Ingredients: bacon, onions, chicken, alfredo soup. 

 Directions: turn oven on to 350 ºF. Mix bacon with onion and then mix chicken and alfredo soup. Then, put into oven for an hour.

>mix mixture with ingredients
You put all the ingredients together and now it is ready to be baked.

>i
You are carrying:
  Uncooked Mixture
  Old Casserole recipe

>put mixture in oven
(Oven)
Oven is closed.

>wait
Time passes.

>open oven
(Oven)
You open Oven.

>put mixture in oven
(Oven)
You put Uncooked Mixture into Oven.

You carefully put the uncooked mixture into the heated oven. Then, you set the timer for an hour and decide to take a nap. As soon as the casserole is done, you should call Jennifer. 

 You wake up an hour later. A delicous smell floats through out the house. Time to take the casserole out.

* * *

I beg your pardon?

>take casserole out
You can't see any such thing.

>take casserole out of oven
You can't see any such thing.

>open oven
(Oven)
That's already open.

>x oven
(Oven)
A standard electric oven. It is fairly new, I only bought it six months ago. The oven controls is a simple knob that has different temperatures on it. 300, 350 and 400.  Now the oven is at a scorching 350ºF.

In Oven is Margret's Casserole.

>take casserole
(Margret's Casserole)
You carefully take the casserole out of the oven. It is still steaming, but it looks scrumptious.

>call 424-8475
After a couple of rings, Jennifer picks up the phone.

 "Hi" says Jennifer. 

"Hello" you say. "I have the casserole ready." 

 "Ok, great, I'll be right over. See you soon!"

    *** you win! ***

Would you like to RESTART, RESTORE a saved game, QUIT or UNDO the last command?

* * *

>open refrigerator
You open Refrigerator, revealing Bacon and Chicken.

* * *

>i
You are carrying nothing.

>l
Instead of looking rule triggered

>l
asdf

>l
asdf

>l'l
That's not a verb I recognise.

>ll
That's not a verb I recognise.

>l
asdf

* * *

>i
You are carrying nothing.

>rules on
Rules tracing now switched on. Type "rules off" to switch it off again, or "rules all" to include even rules which do not apply.

>l
[Rule "declare everything initially unmentioned rule" applies.]
[Rule "determine visibility ceiling rule" applies.]
[Rule "announce items from multiple object lists rule" applies.]
[Rule "set pronouns from items from multiple object lists rule" applies.]
[Rule "before stage rule" applies.]
[Rule "instead stage rule" applies.]
[Rule "Instead of looking" applies.]
asdf
[Rule "A first turn sequence rule" applies.]
[Rule "every turn stage rule" applies.]
[Rule "An every turn rule" applies.]
[Rule "An every turn rule" applies.]
[Rule "A last turn sequence rule" applies.]
[Rule "notify score changes rule" applies.]

* * *

>x recipe locker
I only understood you as far as wanting to examine Recipe storage.

* * *

>x recipe storage
It is a white wood locker that I keep my recipes in. It is closed.

>open
(Unlabled can of soup)
It seems to be locked.

>open recipe storage
You open Recipe storage, revealing Old recipe.

>open recipe storage
That's already open.

>x recipe storage
It is a white wood locker that I keep my recipes in.It is open. There are a bunch of interesting recpies in here, but ther is one that you had intended to make for Jennifer.

In Recipe storage is Old recipe.

>take old recipe
Taken.

>x old recipe
This is a dish that Jennifer and I used to make when we were kids. It is still a good recipe, in fact, I made it a month ago, and it tasted great! But I accidentally ripped the paper when I made it last time. To make matters worse, I've completely forgotten how to make it. I can only make out some writing of the scraps. "Soup"..."oven"..."smokey"..."M and Ms". Not going to be much help, but it's all I got for now.

>l
My Kitchen
This is where I cook my meals everyday. It is a medium sized room with standard kitchen appliances. The oven is in the far corner of the room, and the stove is to your right, and a smoke vent is above it. The refrigerator is on the right wall. There is a marble table in the middle of the room. My recipe locker is next to the refridgerator. The kitchen is lit by while fourecent lights and a window that looks out into the yard.

* * *

>w
Dining Room
This is where meals are eaten. It is a small room consisting of a small wood table, 2 wood chairs, and a utensil cabinet. A glass chandelier casts a warm glow in the room. There is a window that looks out onto Clementine Way. The Kitchen is to the east.

* * *

>e
Living Room
This is the living room where I sit on the couch and watch TV. My address book is here on the coffee table.  The Street is past the front door to the north.

You can see Coffee Table here.

>take table
That's fixed in place.

>open adress book
You can't see any such thing.

>open book
You open Address Book, revealing Jennifer's Number, Mitch's Number, Margret's Number and Steve's Number.

>x Jennifer's number
424-8475

>w
My Kitchen
This is where I cook my meals. It is a medium sized room with an oven and a refrigerator. The oven is in the far corner of the room, The refrigerator is on the right wall. There is a marble table in the middle of the room. My recipe locker is next to the refrigerator. The kitchen is lit by while florescent lights and a window that looks out into the yard. The Dining Room is to the west, the Bed Room is to the south, the Living room is to the east.

* * *

>take phone
Taken.

>call 424-8475
Alright, so I need to ask Jennifer about her plans for tonight. What should I ask about? Dinner? Movies? Shopping? You take a deep breath and dial the number.  After a couple rings, Jennifer's voice comes over the line. "Hello?"

>l
Bed Room
This is where I sleep every night. My bed is right in front of me, the phone and my address book is on the nightstand to the left of the bed, and a desk lamp lights the room. The Kitchen is to the north.

>l
Bed Room
This is where I sleep every night. My bed is right in front of me, the phone and my address book is on the nightstand to the left of the bed, and a desk lamp lights the room. The Kitchen is to the north.

>424-8475
Alright, so I need to ask Jennifer about her plans for tonight. What should I ask about? Dinner? Movies? Shopping? You take a deep breath and dial the number.  After a couple rings, Jennifer's voice comes over the line. "Hello?"

>ask Jennifer about me
There is no reply.

>ask Jennifer about black tonight
There is no reply.

>ask Jennifer about plans tonight
Um, I dont think I have any plans for tonight. Why? Do you want to do something?

>ask jennifer about dinner
"Hmm... Sure." Says Jennifer. "Oh! Remember that old recipie that we used to make as teens? What was it called? Umm...  Margret's Casserole!" 

 "Yes," you say. "I think I still have that recipe in my recipe drawer." 

 "Ok, cool" responds Jennifer. I still have a lot of work to do, so could you call me back when you have it ready?" 

 "Sure," you say. "I'll call you later."

>ask Jennifer about a dinner
I already asked Jennifer about dinner, and she said yes. No need to ask her again.

>ask Jennifer about dinner
I already asked Jennifer about dinner, and she said yes. No need to ask her again.

>story line
That's not a verb I recognise.

>ask Jennifer about dinner
I already asked Jennifer about dinner, and she said yes. No need to ask her again.

>hang up
"Ok, I have to go now." You say. "Bye!" You press the end call button and put down the phone gently.

>ask Jennifer about dinner
You can't see any such thing.

>n
My Kitchen
This is where I cook my meals. It is a medium sized room with an oven and a refrigerator. The oven is in the far corner of the room, The refrigerator is on the right wall. There is a marble table in the middle of the room. My recipe locker is next to the refrigerator. The kitchen is lit by while florescent lights and a window that looks out into the yard. The Dining Room is to the west, the Bed Room is to the south, the Living room is to the east.

>open pantry
You open Pantry, revealing Onion and Unlabeled can of soup.

>take onion
Taken.

>open refridgerator
You can't see any such thing.

>open refrigerator
You open Refrigerator, revealing Bacon and Chicken.

>take bacon
Taken.

>i
You are carrying:
  Bacon
  Onion

>mix bacon and onion
You can't use multiple objects with that verb.

>mix bacon with onion
You mix the bacon and onions until it is well spread out.

>i
You are carrying:
  Chopped Ingredients

>take chicken
Taken.

>take unlabled can of soup
You can't see any such thing.

>l
My Kitchen
This is where I cook my meals. It is a medium sized room with an oven and a refrigerator. The oven is in the far corner of the room, The refrigerator is on the right wall. There is a marble table in the middle of the room. My recipe locker is next to the refrigerator. The kitchen is lit by while florescent lights and a window that looks out into the yard. The Dining Room is to the west, the Bed Room is to the south, the Living room is to the east.

>x pantry
The pantry is where I store all the non-perisable food items.

In Pantry is Unlabeled can of soup.

>take unlabled can of soup
You can't see any such thing.

>take Unlabeled can of soup
Taken.

>open soup
You open Unlabeled can of soup, revealing Orange Soup.

>x soupp
You can't see any such thing.

>x soup
(Unlabeled can of soup)
An unlabeled can of soup. The outside is made of the typical shiny corrugated tin. I wonder what's inside it.

In Unlabeled can of soup is Orange Soup.

>x orange soup
An orange-colored soup. I wonder what it tastes like.

>x unlabeled can of soup
An unlabeled can of soup. The outside is made of the typical shiny corrugated tin. I wonder what's inside it.

In Unlabeled can of soup is Orange Soup.

>take orange soup
Taken.

* * *

>i
You are carrying:
  Orange Soup
  Unlabeled can of soup (open but empty)
  Chicken
  Chopped Ingredients

>mix chicken with orange soup
You mix the chicken with the orange-colored soup until the chicken is fully mixed with the soup.

>i
You are carrying:
  Soupy Mixture
  Chopped Ingredients

>i
You are carrying:
  Soupy Mixture
  Chopped Ingredients

>take old recipe
You can't see any such thing.

>take old recipe
You can't see any such thing.

>take Margret's casserole
You can't see any such thing.

>x recipe sorage
I only understood you as far as wanting to examine Recipe storage.

>x recipe storage
It is a white wood locker that I keep my recipes in. It is closed. There are a bunch of interesting recipes in here, but there is one that you had intended to make for Jennifer. Ole Casserole Recipe.

>take margret's casserole recipe
You can't see any such thing.

>take margret's casserole recipe
You can't see any such thing.

>i
You are carrying:
  Soupy Mixture
  Chopped Ingredients

>open recipe storage
You open Recipe storage, revealing Old Casserole recipe.

>take Margret's casserole recipe
You can't see any such thing.

>i
You are carrying:
  Soupy Mixture
  Chopped Ingredients

* * *

>mis soupy mixture with chopped ingredients
That's not a verb I recognise.

>mix soupy mixture with chopped ingredients
You put all the ingredients together and now it is ready to be baked.

>i
You are carrying:
  Uncooked Mixture

>put uncooked mixture into oven
(Oven)
Oven is closed.

>open oven
(Oven)
You open Oven.

>put uncooked mixture into oven
(Oven)
You put Uncooked Mixture into Oven.

The Oven isn't on! I need to turn it on before I can cook anything in there.

>i
You are carrying:
  Uncooked Mixture

>turn oven to 350
(Oven to that)

>x oven
(Oven)
A standard electric oven. It is fairly new, I only bought it six months ago. The oven controls is a simple knob that has different temperatures on it. 300, 350 and 400.

>turn knob to 350
You can't see any such thing.

>turn oven controls to 350
The oven heats up quickly, and you watch as the temperature rises to 350ºF. You can feel some of the heat radiating off of your face.

>put uncooked mixture in oven
(Oven)
You put Uncooked Mixture into Oven.

You carefully put the uncooked mixture into the heated oven. Then, you set the timer for an hour and decide to take a nap. As soon as the casserole is done, you should call Jennifer. 

 You wake up an hour later. A delicous smell floats through out the house. Time to take the casserole out.

>i
You are carrying nothing.

>l
My Kitchen
This is where I cook my meals. It is a medium sized room with an oven and a refrigerator. The oven is in the far corner of the room, The refrigerator is on the right wall. There is a marble table in the middle of the room. My recipe locker is next to the refrigerator. The kitchen is lit by while florescent lights and a window that looks out into the yard. The Dining Room is to the west, the Bed Room is to the south, the Living room is to the east.

>x oven
(Oven)
A standard electric oven. It is fairly new, I only bought it six months ago. The oven controls is a simple knob that has different temperatures on it. 300, 350 and 400.  Now the oven is at a scorching 350ºF.

In Oven is Margret's Casserole.

>take margret's casserole
You carefully take the casserole out of the oven. It is still steaming, but it looks scrumptious.

>l
My Kitchen
This is where I cook my meals. It is a medium sized room with an oven and a refrigerator. The oven is in the far corner of the room, The refrigerator is on the right wall. There is a marble table in the middle of the room. My recipe locker is next to the refrigerator. The kitchen is lit by while florescent lights and a window that looks out into the yard. The Dining Room is to the west, the Bed Room is to the south, the Living room is to the east.

>take phone
You can't see any such thing.

>take phone
You can't see any such thing.

>take telephone
You can't see any such thing.

>s
Bed Room
This is where I sleep every night. My bed is right in front of me, the phone and my address book is on the nightstand to the left of the bed, and a desk lamp lights the room. The Kitchen is to the north.

You can see Phone here.

>take phone
Taken.

>call 424-8475
After a couple of rings, Jennifer picks up the phone.

 "Hi" says Jennifer. 

"Hello" you say. "I have the casserole ready." 

 "Ok, great, I'll be right over. See you soon!"

    *** you win! ***

Would you like to RESTART, RESTORE a saved game, QUIT or UNDO the last command?

* * *

>s
Bed Room
This is where I sleep every night. My bed is right in front of me, the phone and my address book is on the nightstand to the left of the bed, and a desk lamp lights the room. The Kitchen is to the north.

>l
asdf

>take phone
Taken.

* * *

>l
asdf

>s
You can't go that way.

>n
My Kitchen
This is where I cook my meals. It is a medium sized room with an oven and a refrigerator. The oven is in the far corner of the room, The refrigerator is on the right wall. There is a marble table in the middle of the room. My recipe locker is next to the refrigerator. The kitchen is lit by while florescent lights and a window that looks out into the yard. The Dining Room is to the west, the Bed Room is to the south, the Living room is to the east.

>l
asdf

* * *

>s
Bed Room
This is where I sleep every night. My bed is right in front of me, the phone and my address book is on the nightstand to the left of the bed, and a desk lamp lights the room. The Kitchen is to the north.

>x adress book
You can't see any such thing.

>open adress book
You can't see any such thing.

>x jennifer's number
You can't see any such thing.

* * *

>l
Bed Room
This is where I sleep every night. My bed is right in front of me, the phone and my address book is on the nightstand to the left of the bed, and a desk lamp lights the room. The Kitchen is to the north.

>take phone
Taken.

* * *

>take pack
Taken.

>look table
A black and white marble table. It's been here as long as my house was here.

>w
Dining Room
This is where meals are eaten. It is a small room consisting of a small wood table, and 2 wood chairs. A glass chandelier casts a warm glow in the room. The Kitchen is to the east.

>e
My Kitchen
This is where I cook my meals. It is a medium sized room with an oven and a refrigerator. The oven is in the far corner of the room, the refrigerator is on the right wall. There is a marble table in the middle of the room. My recipe locker is next to the refrigerator. The Dining Room is to the west, the Bed Room is to the south, the Living room is to the east.

You can see Pantry (closed) and Refrigerator (closed) here.

>e
Living Room
This is the living room where I sit on the couch and watch TV. My address book is here on the coffee table. The Street is past the front door to the north.

You can see Coffee Table and Address Book (closed) here.

>take table
That's fixed in place.

>take book
Taken.

>open book
You open Address Book, revealing Jennifer's Number, Mitch's Number, Page's Number and Steve's Number.

>w
My Kitchen
This is where I cook my meals. It is a medium sized room with an oven and a refrigerator. The oven is in the far corner of the room, the refrigerator is on the right wall. There is a marble table in the middle of the room. My recipe locker is next to the refrigerator. The Dining Room is to the west, the Bed Room is to the south, the Living room is to the east.

You can see Pantry (closed) and Refrigerator (closed) here.

>s
Bed Room
This is where I sleep every night. My bed is right in front of me, the phone and my address book is on the nightstand to the left of the bed, and a desk lamp lights the room. The Kitchen is to the north.

You can see Phone here.

* * *

>take phone
Taken.

>call
I didn't understand that sentence.

>call jennifer
I didn't understand that sentence.

>use phone
That's not a verb I recognise.

>call jennifer's number
I didn't understand that sentence.

>look phone
A regular house phone. I don't use it that often, maybe four times a week. It has a dial pad to put in numbers.

>dial pad
I didn't understand that sentence.

>dial jennifer's number
I didn't understand that sentence.

>look book
This is the address book that I keep next to my phone in case I want to call someone.

In Address Book are Jennifer's Number, Mitch's Number, Page's Number and Steve's Number.

>look jennifer's number
424-8475

>dial
I didn't understand that sentence.

>look phone
A regular house phone. I don't use it that often, maybe four times a week. It has a dial pad to put in numbers.

>dial
I didn't understand that sentence.

>type
That's not a verb I recognise.

>use
That's not a verb I recognise.

>use phone
That's not a verb I recognise.

>dial 424-8475
Alright, so I need to ask Jennifer about her plans for tonight. What should I ask about? Dinner? Movies? Shopping? You take a deep breath and dial the number.  After a couple rings, Jennifer's voice comes over the line. "Hello?"

>hi
That's not a verb I recognise.

>ask if she has plans
You can't see any such thing.

>ask about dinner
You can't see any such thing.

>dinner
That's not a verb I recognise.

>ask
What do you want to ask Jennifer for?

>ask dinner
You can't see any such thing.

>ask jennifer
What do you want to ask Jennifer for?

>ask jennifer about dinner
"Hmm... Sure." Says Jennifer. "Oh! Remember that old recipe that we used to make as teens? What was it called? Umm...  Margret's Casserole!" 

 "Yes," you say. "I think I still have that recipe in my recipe drawer." 

 "Ok, cool" responds Jennifer. I still have a lot of work to do, so could you call me back when you have it ready?" 

 "Sure," you say. "I'll call you later."

>end call
"Ok, I have to go now." You say. "Bye!" You press the end call button and put down the phone gently.

>n
My Kitchen
This is where I cook my meals. It is a medium sized room with an oven and a refrigerator. The oven is in the far corner of the room, the refrigerator is on the right wall. There is a marble table in the middle of the room. My recipe locker is next to the refrigerator. The Dining Room is to the west, the Bed Room is to the south, the Living room is to the east.

You can see Pantry (closed) and Refrigerator (closed) here.

>open pantry
You open Pantry, revealing Onion and Unlabeled can of soup.

>take onion and soup
Onion: Taken.
Unlabeled can of soup: Taken.

>open refrigeratior
You open Refrigerator, revealing Bacon and Chicken.

>take bacon and chicken
Bacon: Taken.
Chicken: Taken.

>open oven
(Oven)
You open Oven.

>open locker
You can't see any such thing.

>open recipe
You open Recipe storage, revealing Old Casserole recipe.

>take
What do you want to take?

>take old
Taken.

>look old
This is a dish that Jennifer and I used to make when we were kids. It is still a good recipe, in fact, I made it a month ago, and it tasted great! This is the recipe: 

 Ingredients: bacon, onions, chicken, Alfredo soup. 

 Directions: turn oven on to 350 ºF. Mix bacon with onion and then mix chicken and Alfredo soup. Then, put into oven for an hour.

>turn oven to 350
(Oven to that)

>mix bacon with onion
You mix the bacon and onions until it is well spread out.

>mix chicken and soup
You can't use multiple objects with that verb.

* * *

>mix chicken with alfredo
You can't see any such thing.

>look soup
An unlabeled can of soup. The outside is made of the typical shiny corrugated tin. I wonder what's inside it.

>open soup
You open Unlabeled can of soup, revealing White Soup.

>taste soup
(Unlabeled can of soup)
You taste nothing unexpected.

>look
My Kitchen
This is where I cook my meals. It is a medium sized room with an oven and a refrigerator. The oven is in the far corner of the room, the refrigerator is on the right wall. There is a marble table in the middle of the room. My recipe locker is next to the refrigerator. The Dining Room is to the west, the Bed Room is to the south, the Living room is to the east.

You can see Pantry (empty) and Refrigerator (empty) here.

>look locker
You can't see any such thing.

>look recipe
(Old Casserole recipe)
This is a dish that Jennifer and I used to make when we were kids. It is still a good recipe, in fact, I made it a month ago, and it tasted great! This is the recipe: 

 Ingredients: bacon, onions, chicken, Alfredo soup. 

 Directions: turn oven on to 350 ºF. Mix bacon with onion and then mix chicken and Alfredo soup. Then, put into oven for an hour.

>look recipe locker
You can't see any such thing.

>mix chicken with soup
(Unlabeled can of soup)

>put in oven
I didn't understand that sentence.

>inventory
You are carrying:
  Chopped Ingredients
  Old Casserole recipe
  Chicken
  Unlabeled can of soup (open)
    White Soup
  Address Book (open)
    Jennifer's Number
    Mitch's Number
    Page's Number
    Steve's Number
  Cigarette Pack (closed)

>mix chicken with white soup
You mix the chicken with the white-colored soup until the chicken is fully mixed with the soup.

* * *

>i
You are carrying:
  Soupy Mixture
  Chopped Ingredients
  Old Casserole recipe
  Address Book (open)
    Jennifer's Number
    Mitch's Number
    Page's Number
    Steve's Number
  Cigarette Pack (closed)

>mix soupy mixture with chopped ingredients
You put all the ingredients together and now it is ready to be baked.

>i
You are carrying:
  Uncooked Mixture
  Old Casserole recipe
  Address Book (open)
    Jennifer's Number
    Mitch's Number
    Page's Number
    Steve's Number
  Cigarette Pack (closed)

>put mixture in oven
(Oven)
You put Uncooked Mixture into Oven.

The Oven isn't on! I need to turn it on before I can cook anything in there.

>turn on oven
(Oven)
It isn't something you can switch.

>turn oven to 350
(Oven to that)

>look oven
(Oven)
A standard electric oven. It is fairly new, I only bought it six months ago. The oven controls has different temperatures on it. 300, 350 and 400. It can be set by TURNING oven controls to a temperature

>turn oven control to 350
You can't see any such thing.

>turn oven controls to 350
The oven heats up quickly, and you watch as the temperature rises to 350ºF. You can feel some of the heat radiating off of your face.

>put uncooked mixture into oven
(Oven)
You put Uncooked Mixture into Oven.

You carefully put the uncooked mixture into the heated oven. Then, you set the timer for an hour and decide to take a nap. As soon as the casserole is done, you should call Jennifer. 

 You wake up an hour later. A delicious smell floats through out the house. Time to take the casserole out.

>take out casserole
I only understood you as far as wanting to take outside.

>look oven
(Oven)
A standard electric oven. It is fairly new, I only bought it six months ago. The oven controls has different temperatures on it. 300, 350 and 400. It can be set by TURNING oven controls to a temperature  Now the oven is at a scorching 350ºF.

In Oven is Margret's Casserole.

>take casserole
(Margret's Casserole)
You carefully take the casserole out of the oven. It is still steaming, but it looks scrumptious.

>taste casserole
Which do you mean, Margret's Casserole or Old Casserole recipe?

>margrets
You can't see any such thing.

>taste margret
You can't see any such thing.

>taste margrets casserole
You can't see any such thing.

>e
Living Room
This is the living room where I sit on the couch and watch TV. My address book is here on the coffee table. The Street is past the front door to the north.

You can see Coffee Table here.

>w
My Kitchen
This is where I cook my meals. It is a medium sized room with an oven and a refrigerator. The oven is in the far corner of the room, the refrigerator is on the right wall. There is a marble table in the middle of the room. My recipe locker is next to the refrigerator. The Dining Room is to the west, the Bed Room is to the south, the Living room is to the east.

You can see Pantry (empty) and Refrigerator (empty) here.

>w
Dining Room
This is where meals are eaten. It is a small room consisting of a small wood table, and 2 wood chairs. A glass chandelier casts a warm glow in the room. The Kitchen is to the east.

>e
My Kitchen
This is where I cook my meals. It is a medium sized room with an oven and a refrigerator. The oven is in the far corner of the room, the refrigerator is on the right wall. There is a marble table in the middle of the room. My recipe locker is next to the refrigerator. The Dining Room is to the west, the Bed Room is to the south, the Living room is to the east.

You can see Pantry (empty) and Refrigerator (empty) here.

>e
Living Room
This is the living room where I sit on the couch and watch TV. My address book is here on the coffee table. The Street is past the front door to the north.

You can see Coffee Table here.

>n
Clementine Way
This is the street that runs past the front of my house. Good thing the streetlights are on, otherwise, it would be pitch black. The sidewalk and asphalt are in good condition. Cool autumn breezes make you shiver slightly. The Intersection by Jennifer's house is to the east, and my house is to the south.

>e
Intersection
This is a well-lit intersection.  Clementine Way and Walnut street meet here in a T. Only a stop sign controls traffic in the intersection. The cool air feels nice on my face. Jennifer's house is to the south.

>s
Jennifer's Porch
I am now standing in front of Jennifer's door. She has a white medium-sized house. The porch is made of red plastic.  I go and knock on the door and call her name, but there is no response. The lights are still on, and the water is not running. I need to find a way inside. I know Jennifer keeps a secret key around here somewhere... The intersection is to the north, and Jennifer's door is to the south.

It is a wood door painted red. It has a simple brass keyhole and brass knob. The plaque on the door presents the numbers "6512"

>s
(first opening Jennifer's Door)
It seems to be locked.

>dial 424-8475
I don't have anything to call with!

>look for key
You can't see any such thing.

>n
Intersection
This is a well-lit intersection.  Clementine Way and Walnut street meet here in a T. Only a stop sign controls traffic in the intersection. The cool air feels nice on my face. Jennifer's house is to the south.

>n
You can't go that way.

>s
Jennifer's Porch
I am now standing in front of Jennifer's door. She has a white medium-sized house. The porch is made of red plastic.  I go and knock on the door and call her name, but there is no response. The lights are still on, and the water is not running. I need to find a way inside. I know Jennifer keeps a secret key around here somewhere... The intersection is to the north, and Jennifer's door is to the south.

It is a wood door painted red. It has a simple brass keyhole and brass knob. The plaque on the door presents the numbers "6512"

>e
You can't go that way.

>w
Jennifer's Garden
This is Jennifer's Garden. There is a little shed here that looks like it holds all sorts of stuff. The garden consits of a small flower bed off to the left and a vegetable patch to the right.

You can see Little Shed (closed) and Turn Dial Lock here.

>look lock
A simple turn dial lock that holds the doors to the shed closed. The dial can be spun all the way to 9000. I wonder if there is anything that would help me find the right number for this lock.

>turn lock to 6512
with a satisfying click, the lock opens, and you pull open the doors of the shed. To your surprise, the shed is empty except for a key that is dangling by a string in the middle of the shed.

>take key
Taken.

>e
Jennifer's Porch
I am now standing in front of Jennifer's door. She has a white medium-sized house. The porch is made of red plastic.  The intersection is to the north, and Jennifer's door is to the south.

It is a wood door painted red. It has a simple brass keyhole and brass knob. The plaque on the door presents the numbers "6512"

>s
(first opening Jennifer's Door)
It seems to be locked.

>unlock dorr
You can't see any such thing.

>unlock door
What do you want to unlock Jennifer's Door with?

>unlock door with key
You unlock Jennifer's Door.

>s
(first opening Jennifer's Door)

Jennifer's Living Room
This is Jennifer's Living Room. I've only been over here once or twice. It is a fairly large room, but it has a cozy feeling to it. Jennifer's Porch is to the north.

It is a wood door painted red. It has a simple brass keyhole and brass knob. The plaque on the door presents the numbers "6512"

You can also see Bottle of insulin and Bottle of Glucose here.

You see Jennifer passed out on the rug. At first you think that she is just sleeping, but then you notice a bottle of insulin and a bottle of glucose next to her! Maybe I should ask her about if she is ok, about the insulin bottle or the glucose bottle?

>take insulin
Taken.

You see Jennifer passed out on the rug. At first you think that she is just sleeping, but then you notice a bottle of insulin and a bottle of glucose next to her! Maybe I should ask her about if she is ok, about the insulin bottle or the glucose bottle?

>take glucose
Taken.

You see Jennifer passed out on the rug. At first you think that she is just sleeping, but then you notice a bottle of insulin and a bottle of glucose next to her! Maybe I should ask her about if she is ok, about the insulin bottle or the glucose bottle?

>s
You can't go that way.

You see Jennifer passed out on the rug. At first you think that she is just sleeping, but then you notice a bottle of insulin and a bottle of glucose next to her! Maybe I should ask her about if she is ok, about the insulin bottle or the glucose bottle?

>s
You can't go that way.

You see Jennifer passed out on the rug. At first you think that she is just sleeping, but then you notice a bottle of insulin and a bottle of glucose next to her! Maybe I should ask her about if she is ok, about the insulin bottle or the glucose bottle?

>unlock door with key
That's unlocked at the moment.

You see Jennifer passed out on the rug. At first you think that she is just sleeping, but then you notice a bottle of insulin and a bottle of glucose next to her! Maybe I should ask her about if she is ok, about the insulin bottle or the glucose bottle?

>l
Jennifer's Living Room
This is Jennifer's Living Room. I've only been over here once or twice. It is a fairly large room, but it has a cozy feeling to it. Jennifer's Porch is to the north.

It is a wood door painted red. It has a simple brass keyhole and brass knob. The plaque on the door presents the numbers "6512"

You see Jennifer passed out on the rug. At first you think that she is just sleeping, but then you notice a bottle of insulin and a bottle of glucose next to her! Maybe I should ask her about if she is ok, about the insulin bottle or the glucose bottle?

>hax m8
That's not a verb I recognise.

>s
You can't go that way.

You see Jennifer passed out on the rug. At first you think that she is just sleeping, but then you notice a bottle of insulin and a bottle of glucose next to her! Maybe I should ask her about if she is ok, about the insulin bottle or the glucose bottle?

>e
You can't go that way.

You see Jennifer passed out on the rug. At first you think that she is just sleeping, but then you notice a bottle of insulin and a bottle of glucose next to her! Maybe I should ask her about if she is ok, about the insulin bottle or the glucose bottle?

>w
You can't go that way.

You see Jennifer passed out on the rug. At first you think that she is just sleeping, but then you notice a bottle of insulin and a bottle of glucose next to her! Maybe I should ask her about if she is ok, about the insulin bottle or the glucose bottle?

>sw
You can't go that way.

You see Jennifer passed out on the rug. At first you think that she is just sleeping, but then you notice a bottle of insulin and a bottle of glucose next to her! Maybe I should ask her about if she is ok, about the insulin bottle or the glucose bottle?

>se
You can't go that way.

You see Jennifer passed out on the rug. At first you think that she is just sleeping, but then you notice a bottle of insulin and a bottle of glucose next to her! Maybe I should ask her about if she is ok, about the insulin bottle or the glucose bottle?

>l
Jennifer's Living Room
This is Jennifer's Living Room. I've only been over here once or twice. It is a fairly large room, but it has a cozy feeling to it. Jennifer's Porch is to the north.

It is a wood door painted red. It has a simple brass keyhole and brass knob. The plaque on the door presents the numbers "6512"

You see Jennifer passed out on the rug. At first you think that she is just sleeping, but then you notice a bottle of insulin and a bottle of glucose next to her! Maybe I should ask her about if she is ok, about the insulin bottle or the glucose bottle?

>i
You are carrying:
  Bottle of Glucose
  Bottle of insulin
  Jennifer's Key
  Margret's Casserole
  Old Casserole recipe
  Address Book (open)
    Jennifer's Number
    Mitch's Number
    Page's Number
    Steve's Number
  Cigarette Pack (closed)

You see Jennifer passed out on the rug. At first you think that she is just sleeping, but then you notice a bottle of insulin and a bottle of glucose next to her! Maybe I should ask her about if she is ok, about the insulin bottle or the glucose bottle?

>look jennifer
You see nothing special about Jennifer.

You see Jennifer passed out on the rug. At first you think that she is just sleeping, but then you notice a bottle of insulin and a bottle of glucose next to her! Maybe I should ask her about if she is ok, about the insulin bottle or the glucose bottle?

>use glucose
That's not a verb I recognise.

>open glucose
It isn't something you can open.

You see Jennifer passed out on the rug. At first you think that she is just sleeping, but then you notice a bottle of insulin and a bottle of glucose next to her! Maybe I should ask her about if she is ok, about the insulin bottle or the glucose bottle?

>hit jennifer
Violence isn't the answer to this one.

You see Jennifer passed out on the rug. At first you think that she is just sleeping, but then you notice a bottle of insulin and a bottle of glucose next to her! Maybe I should ask her about if she is ok, about the insulin bottle or the glucose bottle?

>wake up jennifer
That seems unnecessary.

You see Jennifer passed out on the rug. At first you think that she is just sleeping, but then you notice a bottle of insulin and a bottle of glucose next to her! Maybe I should ask her about if she is ok, about the insulin bottle or the glucose bottle?

>ask jennifer if she is ok
I didn't understand that sentence.

>ask if she is ok
You can't see any such thing.

>ask jennifer about if she is ok
"Hey Jennifer, are you okay?!" You ask.

 Jennifer groans. "Thank goodness you came by. I am low on blood sugar and I ran out of glucose." She says.

You see Jennifer passed out on the rug. At first you think that she is just sleeping, but then you notice a bottle of insulin and a bottle of glucose next to her! Maybe I should ask her about if she is ok, about the insulin bottle or the glucose bottle?

>ask jennifer about glucose
I use glucose to keep my blood sugar up. I just ran out, and I don't have anything sweet right now. Anything with sugar will help me to get my blood sugar back up.

>feed jennifer casserole
Which do you mean, Margret's Casserole or Old Casserole recipe?

>feed jennifer glucose
Jennifer doesn't seem interested.

>feed jennifer margrets casserole
You can't see any such thing.

>offer margrets cassserole
You can't see any such thing.

* * *

>n
Jennifer's Porch
I am now standing in front of Jennifer's door. She has a white medium-sized house. The porch is made of red plastic.  The intersection is to the north, and Jennifer's door is to the south.

It is a wood door painted red. It has a simple brass keyhole and brass knob. The plaque on the door presents the numbers "6512"

>s
Jennifer's Living Room
This is Jennifer's Living Room. I've only been over here once or twice. It is a fairly large room, but it has a cozy feeling to it. Jennifer's Porch is to the north.

It is a wood door painted red. It has a simple brass keyhole and brass knob. The plaque on the door presents the numbers "6512"

>s
You can't go that way.

>w
You can't go that way.

>e
You can't go that way.

>open pack
You open Cigarette Pack, revealing MnMs.

>take mnms
Taken.

>feed mnms to jennifer
Jennifer gladly takes the MnMs and eats them. After a few minutes, she sits up and thanks you. "Thanks for coming over. I was in a tight spot. Did you find my key in the shed? I put a key in there for emergencies. So, are we going to have dinner?"

 You lead Jennifer back to your house and serve Margret's Casserole for dinner.

    *** you win! ***

Would you like to RESTART, RESTORE a saved game, QUIT or UNDO the last command?

* * *

>take pack
Taken.

>open pantry
You open Pantry, revealing Onion and Unlabeled can of soup.

>take all
You hold out your hand, close your eyes, and concentrate. You will all objects to fly to you, but nothing happens.

>take onion
Taken.

>take soup
Taken.

>look oven
(Oven)
A standard electric oven. It is fairly new, I only bought it six months ago. The oven controls has different temperatures on it. 300, 350 and 400. It can be set by TURNING oven controls to a temperature

>open fridge
You can't see any such thing.

>open refrigeration
You open Refrigerator, revealing Bacon and Chicken.

>take bacon and chicken
Bacon: Taken.
Chicken: Taken.

>look locker
You can't see any such thing.

>look recipe
It is a white wood storage container that I keep my recipes in. I call it my recipe storage. It is closed.

>open recipe
You open Recipe storage, revealing Old Casserole recipe.

>take casserole
Taken.

>look casserole
This is a dish that Jennifer and I used to make when we were kids. It is still a good recipe, in fact, I made it a month ago, and it tasted great! This is the recipe: 

 Ingredients: bacon, onions, chicken, Alfredo soup. 

 Directions: turn oven on to 350 ºF. Mix bacon with onion and then mix chicken and Alfredo soup. Then, put into oven for an hour.

>turn oven to 350
(Oven to that)

* * *

>put in oven
I didn't understand that sentence.

>put in oven for 1 hour
I didn't understand that sentence.

>open oven
(Oven)
You open Oven.

>put in oven
I didn't understand that sentence.

>put casserole in oven
(Oven)
You put Old Casserole recipe into Oven.

>wait hour
I only understood you as far as wanting to wait.

>wait
Time passes.

>exit
But you aren't in anything at the moment.

>take out casserole
I only understood you as far as wanting to take outside.

>take out casserole from oven
You can't see any such thing.

>mix bacon with onion with chicken with soup
I only understood you as far as wanting to mix Bacon with Onion.

>mix all
You can't use multiple objects with that verb.